22222222
22222112
21212132
22212222
22223222
26222222
22222622
66666666