FFFFFFFF
FEBFFFFF
FFFFBFFF
FBFFEFBF
FEFFFFFE
FFFBFFFF
FFFFEFBF
FFFFFFFF