22222226
22211426
22222226
21226226
21222226
24122226
22426266
22222226