DEEEEEEE
2DDEEEEE
22DEEEEE
223DEEEE
2222DEEE
21222DDE
214223DE
2221243D