22222222
22222222
22122222
22112222
22442122
22222122
22222442
21422222