62221222
62221142
62222222
82222222
82222212
82222132
88222222
E8888666